** *******
*        *
* ****** *
*     ** *
***** ** E
*   * ****
* * *    *
* * **** *
* *      *
* ********
