******* *******
*    *  *     *
* ** ** * *** *
* *   *     * *
* * ******* * *
* * *     *** *
* * * *** * * *
  * *   *   *  
*** ***** * * *
*         * * *
* ********* * *
* *         * *
* * ******* * *
* *       *   *
*******E*******
